
/* Syntax Part */
Program : program id semicolon VarsOp FuncLoop ;

VarsOp : Vars | empty ;

Vars : var Variable VarsPrime ;

VarsPrime : Variable VarsPrime | empty ;

Variable : id MasId colon Type semicolon ;

MasId : comma id MasId | empty ;

Type : int | float ;

FuncLoop : Funcs AfterLoop | empty ;

AfterLoop : FuncLoop | empty ;

Funcs : void id lparen Params rparen lbracket VarsOpt Body rbracket semicolon ;

Params : ParamIndiv MoreParam | empty ;

ParamIndiv : id colon Type ;

MoreParam : comma ParamIndiv MoreParam | empty ;

VarsOpt : Vars | empty ;

Body : lbrace StateDeclare rbrace ;

StateDeclare : Statement StateLoop | empty ;

StateLoop : StateDeclare | empty ;

Statement : Assign 
          | Condition 
          | Cycle 
          | FuncCall 
          | Print ;

Assign : id assign Expresion semicolon ;

Condition : if lparen Expresion rparen Body ElseBody semicolon ;

ElseBody : else Body | empty ;

Cycle : while lparen Expresion rparen do Body semicolon ;

FuncCall : id lparen ArgList rparen semicolon ;

ArgList : Expresion MoreCall | empty ;

MoreCall : comma Expresion MoreCall | empty ;

Print : print lparen PrintList rparen semicolon ;

PrintList : PrintItem MorePrint ;

PrintItem : Expresion 
          | cte_string ;

MorePrint : comma PrintItem MorePrint | empty ;

Expresion : Exp MoreExpresion ;

MoreExpresion : Exp1 | Exp2 | Exp3 | empty ;

Exp1 : greater Exp ;

Exp2 : less Exp ;

Exp3 : notequal Exp ;

Exp : Termino MoreExp ;

MoreExp : plus Termino MoreExp
        | minus Termino MoreExp
        | empty ;

Termino : Factor MoreTermino ;

MoreTermino : times Factor MoreTermino
            | divide Factor MoreTermino
            | empty ;

Factor : lparen Expresion rparen 
       | Op NextOp ;

Op : plus | minus | empty ;

NextOp : id | Cte ;

Cte : cte_int | cte_float ;